NO    texture/wall1_shadow.xpm
WE    texture/wall1.xpm
SO    texture/wall1.xpm
EA    texture/wall.xpm
C     50, 50, 50
F 25,52,56



1111111111111111111111111111
1110000000000000000000000001
1000010011010000000000000001
1000000000000000000000000001
1011110000000000000000000001
1010101001111111000010000001
1010000011000001000000000001
101010000100N001000000000001
1010100001000001000000000001
1001000001111111000000000001
1010000000000000000000000001
1000000000000000000000000001
1100010000000000000000000001
1111111111111111111111111111
