NO    texture/cat.xpm
WE    texture/cat.xpm
SO    texture/cat.xpm
EA    texture/cat.xpm
C     50, 50, 50
F     150,150,150



11111111111
1E000000001
11111111111
