NO    texture/wall.xpm
WE    texture/wall.xpm
SO    texture/wall.xpm
EA    texture/wall.xpm
C     50, 50, 50
F 25,52,52



1111111111111111111111111111
1110000000000000000000000001
1000010011010000000000000001
1000000000000000000000000001
10111100W0000000000000000001
1010101001000000000010000001
1010000010000001000000000001
1010100000000000000000000001
1001000000000000000000000001
1010000000000000000000000001
1000000000000000000000000001
1100010000000000000000000001
1111111111111111111111111111
