  C 21, 255, 20
WE .a
SO .b
                             
EA .c
F 42              ,24,44 
NO .d



111111111111111111
101111111111111001
1000E0000011111001
1000000000000000111
11111111111111111111