  C 21, 255, 255
WE .
SO .r
                             
EA .
F 0              ,0,0 
NO .



111111111111111111
101111111111111001
1000E0000011111001
1000000000000000111
11111111111111111111