NO    texture/wall.xpm
WE    texture/wall.xpm
SO    texture/wall.xpm
EA    texture/wall.xpm
C     50, 50, 50
F     150,150,150

11111 11111
10001110001
10000000001
10001110001
11111 11111