NO                      ./img/optic/4.png
WE                                                           ./img/optic/3.png
                     C     0,        0,         0
                               SO ./img/optic/2.png
EA ./img/optic/1.png








F 255,255,255


       1
      1S1
     10001
    1000001
   111101111
      101111111111
      100000000001
      111111111101            111
               101111111111111001
              100000000000000001
11111 1111111111111111111111111