NO                      ./img/optic/4.png       
WE                                   ./img/optic/3.png               
                       
                        
                                     
                                     



 
                     C   99 ,7, 8
                               SO ./img/optic/2.png
EA ./img/optic/1.png   

a


F 215,50,25
     




                      
       1
      1S1
     10001
    1000001
   111101111
      101111111111
      1000000a0001
      111111111101            111
               101111111111111001
              100000000000000001
11111 1111111111111111111111111

11111111111
10000 00001
11111111111 