        C 99,7, 8

NO    .
WE     .
SO .
EA .
F 215,              250,255 9

111111
10S001
100001
111111