
NO    .
WE     .
SO .
EA .
C 99,7, 8
F 215,50,25

111101
10S001
100001
110111