        C 99,7, 8
NO e
NO    .
WE     .
SO .
EA .
F 215              ,250,255 


111111
10S001
100001
111111