NO    texture/wall1_shadow.xpm
WE    texture/wall1_shadow.xpm
SO    texture/wall1_shadow.xpm
EA    texture/wall1.xpm
C     50, 50, 50
F     150,150,150



11111   11111   11111
100111111000111111001
100000000000000000001
100011111000111110001
11011   11011   11011
 101     101     101
 101     101     101
 101     101     101
11011   11011   11011
100011111000111110001
1000000000N0000000001
100011111000111110001
11011   11011   11011
 101     101     101
 101     101     101
 101     101     101
11011   11011   11011
100111111000111111001
100000000000000000001
100011111000111110001
11111   11111   11111